%%%%%%%%%%%%%%%%%
%.......%......%%
%.%%%.%.%.%%%.%%%
%.% P.% %.% G...%
%.%%%.%.%.%%%.%%%
%.......o.....%%%
%%%%%%%%%%%%%%%%%
